

2 1
3 2 1
4 2 1
5 4 2 1
6 4 2 1
7 6 4 2 1
8 4 2 1
9 8 4 2 1
10 8 4 2 1
11 10 8 4 2 1
12 8 4 2 1
13 12 8 4 2 1
14 12 8 4 2 1
15 10 5 4 2 1
16 8 4 2 1
17 16 8 4 2 1
18 16 8 4 2 1
19 18 16 8 4 2 1
20 16 8 4 2 1
21 20 16 8 4 2 1
22 20 16 8 4 2 1
23 18 9 5 4 2 1
24 16 8 4 2 1
25 24 16 8 4 2 1
26 24 16 8 4 2 1
27 18 9 8 4 2 1
28 24 16 8 4 2 1
29 28 24 16 8 4 2 1
30 20 10 8 4 2 1
31 30 20 10 8 4 2 1
32 16 8 4 2 1
33 32 16 8 4 2 1
34 32 16 8 4 2 1
35 34 32 16 8 4 2 1
36 32 16 8 4 2 1
37 36 32 16 8 4 2 1
38 36 32 16 8 4 2 1
39 26 13 12 8 4 2 1
40 32 16 8 4 2 1
41 40 32 16 8 4 2 1
42 40 32 16 8 4 2 1
43 34 17 9 8 4 2 1
44 40 32 16 8 4 2 1
45 36 18 9 8 4 2 1
46 36 18 10 8 4 2 1
47 39 26 13 12 8 4 2 1
48 32 16 8 4 2 1
49 48 32 16 8 4 2 1
50 48 32 16 8 4 2 1
51 34 17 16 8 4 2 1
52 48 32 16 8 4 2 1
53 52 48 32 16 8 4 2 1
54 36 18 16 8 4 2 1
55 54 36 18 16 8 4 2 1
56 48 32 16 8 4 2 1
57 56 48 32 16 8 4 2 1
58 56 48 32 16 8 4 2 1
59 51 34 17 16 8 4 2 1
60 40 20 16 8 4 2 1
61 60 40 20 16 8 4 2 1
62 60 40 20 16 8 4 2 1
63 42 21 20 16 8 4 2 1
64 32 16 8 4 2 1
65 64 32 16 8 4 2 1
66 64 32 16 8 4 2 1
67 66 64 32 16 8 4 2 1
68 64 32 16 8 4 2 1
69 68 64 32 16 8 4 2 1
70 68 64 32 16 8 4 2 1
71 70 68 64 32 16 8 4 2 1
72 64 32 16 8 4 2 1
73 72 64 32 16 8 4 2 1
74 72 64 32 16 8 4 2 1
75 50 25 24 16 8 4 2 1
76 72 64 32 16 8 4 2 1
77 68 34 17 9 8 4 2 1
78 52 26 24 16 8 4 2 1
79 78 52 26 24 16 8 4 2 1
80 64 32 16 8 4 2 1
81 80 64 32 16 8 4 2 1
82 80 64 32 16 8 4 2 1
83 66 33 17 16 8 4 2 1
84 80 64 32 16 8 4 2 1
85 68 34 17 16 8 4 2 1
86 68 34 18 16 8 4 2 1
87 58 29 28 24 16 8 4 2 1
88 80 64 32 16 8 4 2 1
89 88 80 64 32 16 8 4 2 1
90 72 36 18 16 8 4 2 1
91 75 50 25 24 16 8 4 2 1
92 72 36 20 16 8 4 2 1
93 92 72 36 20 16 8 4 2 1
94 78 52 26 24 16 8 4 2 1
95 74 37 21 20 16 8 4 2 1
96 64 32 16 8 4 2 1
97 96 64 32 16 8 4 2 1
98 96 64 32 16 8 4 2 1
99 66 33 32 16 8 4 2 1
100 96 64 32 16 8 4 2 1
101 100 96 64 32 16 8 4 2 1
102 68 34 32 16 8 4 2 1
103 102 68 34 32 16 8 4 2 1
104 96 64 32 16 8 4 2 1
105 104 96 64 32 16 8 4 2 1
106 104 96 64 32 16 8 4 2 1
107 99 66 33 32 16 8 4 2 1
108 72 36 32 16 8 4 2 1
109 108 72 36 32 16 8 4 2 1
110 108 72 36 32 16 8 4 2 1
111 74 37 36 32 16 8 4 2 1
112 96 64 32 16 8 4 2 1
113 112 96 64 32 16 8 4 2 1
114 112 96 64 32 16 8 4 2 1
115 99 66 33 32 16 8 4 2 1
116 112 96 64 32 16 8 4 2 1
117 100 50 34 17 16 8 4 2 1
118 102 68 34 32 16 8 4 2 1
119 102 68 34 17 16 8 4 2 1
120 80 40 32 16 8 4 2 1
121 120 80 40 32 16 8 4 2 1
122 120 80 40 32 16 8 4 2 1
123 82 41 40 32 16 8 4 2 1
124 120 80 40 32 16 8 4 2 1
125 100 50 25 24 16 8 4 2 1
126 84 42 40 32 16 8 4 2 1
127 126 84 42 40 32 16 8 4 2 1
128 64 32 16 8 4 2 1
129 128 64 32 16 8 4 2 1
130 128 64 32 16 8 4 2 1
131 130 128 64 32 16 8 4 2 1
132 128 64 32 16 8 4 2 1
133 132 128 64 32 16 8 4 2 1
134 132 128 64 32 16 8 4 2 1
135 90 45 36 18 9 8 4 2 1
136 128 64 32 16 8 4 2 1
137 136 128 64 32 16 8 4 2 1
138 136 128 64 32 16 8 4 2 1
139 138 136 128 64 32 16 8 4 2 1
140 136 128 64 32 16 8 4 2 1
141 140 136 128 64 32 16 8 4 2 1
142 140 136 128 64 32 16 8 4 2 1
143 111 74 37 36 32 16 8 4 2 1
144 128 64 32 16 8 4 2 1
145 144 128 64 32 16 8 4 2 1
146 144 128 64 32 16 8 4 2 1
147 98 49 48 32 16 8 4 2 1
148 144 128 64 32 16 8 4 2 1
149 132 66 33 17 16 8 4 2 1
150 100 50 48 32 16 8 4 2 1
151 150 100 50 48 32 16 8 4 2 1
152 144 128 64 32 16 8 4 2 1
153 136 68 34 17 16 8 4 2 1
154 136 68 34 18 16 8 4 2 1
155 147 98 49 48 32 16 8 4 2 1
156 104 52 48 32 16 8 4 2 1
157 156 104 52 48 32 16 8 4 2 1
158 156 104 52 48 32 16 8 4 2 1
159 106 53 52 48 32 16 8 4 2 1
160 128 64 32 16 8 4 2 1
161 160 128 64 32 16 8 4 2 1
162 160 128 64 32 16 8 4 2 1
163 130 65 33 32 16 8 4 2 1
164 160 128 64 32 16 8 4 2 1
165 132 66 33 32 16 8 4 2 1
166 132 66 34 32 16 8 4 2 1
167 166 132 66 34 32 16 8 4 2 1
168 160 128 64 32 16 8 4 2 1
169 168 160 128 64 32 16 8 4 2 1
170 136 68 34 32 16 8 4 2 1
171 114 57 56 48 32 16 8 4 2 1
172 136 68 36 32 16 8 4 2 1
173 172 136 68 36 32 16 8 4 2 1
174 116 58 56 48 32 16 8 4 2 1
175 138 69 37 36 32 16 8 4 2 1
176 160 128 64 32 16 8 4 2 1
177 176 160 128 64 32 16 8 4 2 1
178 176 160 128 64 32 16 8 4 2 1
179 147 98 49 48 32 16 8 4 2 1
180 144 72 36 32 16 8 4 2 1
181 180 144 72 36 32 16 8 4 2 1
182 150 100 50 48 32 16 8 4 2 1
183 146 73 37 36 32 16 8 4 2 1
184 144 72 40 32 16 8 4 2 1
185 184 144 72 40 32 16 8 4 2 1
186 184 144 72 40 32 16 8 4 2 1
187 146 73 41 40 32 16 8 4 2 1
188 156 104 52 48 32 16 8 4 2 1
189 148 74 41 33 32 16 8 4 2 1
190 148 74 42 40 32 16 8 4 2 1
191 159 106 53 52 48 32 16 8 4 2 1
192 128 64 32 16 8 4 2 1
193 192 128 64 32 16 8 4 2 1
194 192 128 64 32 16 8 4 2 1
195 130 65 64 32 16 8 4 2 1
196 192 128 64 32 16 8 4 2 1
197 196 192 128 64 32 16 8 4 2 1
198 132 66 64 32 16 8 4 2 1
199 198 132 66 64 32 16 8 4 2 1
200 192 128 64 32 16 8 4 2 1
